|=============|===================|===============|
|             |                   |               |
|                                 |               |
|             |==========|==  ====|               |
|===  ========|          |        |               |
|             |                                   |
|                        |        |               |
|             |=====  ===|==|=====|==|=====  =====|
|             |             |        |            |
|                           |        |            |
|=  =|====  ==|             |        |            |
|    |        |             |                     |
|    |        |             |        |            |
|    |                               |            |
|    |        |             |        |            |
|    |        |=====  ======|===  ===|=====  =====|
|=  =|==  ====|                      |            |
|             |                      |            |
|                                    |            |
|             |                      |            |
|========|====|===|===  =============|============|
|        |        |                  |            |
|                                    |            |
|        |        |                  |            *
|        |===  ===|=========|===  ===|            *
|        |                  |        |            |
|        |                                        |
|        |                  |        |            |
|========|==================|========|============|